111111111
1P0000001
1E0000001
100000CC1
111111111