1111111111111111111111111111111111111111111111111111111111111111
1111111111111111111111111111111111111111111111111111111111111111
1111111111111000000000000000000000000000000000000000000000001111
1111111111111000000000000000000000000000000000000000000000001111
1111111111111000000000000000000000000000000000000000000000001111
1111111111111000000000000000000000000000000000000000000000001111
1111111111111000000000000000000000000000000000000000000000001111
1111111111111000000000000000000000000000000000000000000000001111
1111111111111000000000000000000000000000000000000000000000001111
1111111111111000000001111111111111111111111111111111000000111111
1111111111111000000001111111111111111111111111111111000000111111
1111111111111000000001111111111111111111111111111111000000111111
1111111111111000000001111111111111111111111111111111000000111111
1111111111111000000001111111111111111111111111111111000000111111
1111111111111000000001111111111111111111111111111111000000111111
1111111111111000000001111111111111111111111111111111000000111111
1111111111111000000001111111111111111111111111111111000000111111
111111P000000000000000000000000000000000000000000000000000000E11
1110000000000000000000000000000000000011111111111111111111111111
111000CCCCCCCCCCCCCCCCCCCCCCCCCCCC000011111111111111111111111111
111000CCCCCCCCCCCCCCCCCCCCCCCCCCCC000011111111111111111111111111
111000CCCCCCCCCCCCCCCCCCCCCCCCCCCC000011111111111111111111111111
111000CCCCCCCCCCCCCCCCCCCCCCCCCCCC000011111111111111111111111111
111000CCCCCCCCCCCCCCCCCCCCCCCCCCCC000011111111111111111111111111
111000CCCCCCCCCCCCCCCCCCCCCCCCCCCC000011111111111111111111111111
111000CCCCCCCCCCCCCCCCCCCCCCCCCCCC000011111111111111111111111111
111000CCCCCCCCCCCCCCCCCCCCCCCCCCCC000011111111111111111111111111
111000CCCCCCCCCCCCCCCCCCCCCCCCCCCC000011111111111111111111111111
111000CCCCCCCCCCCCCCCCCCCCCCCCCCCC000011111111111111111111111111
111000CCCCCCCCCCCCCCCCCCCCCCCCCCCC000011111111111111111111111111
1110000000000000000000000000000000000011111111111111111111111111
1111111111111111111111111111111111111111111111111111111111111111
1111111111111111111111111111111111111111111111111111111111111111