1111111111111111111111111111111111
1111111111111111111111111111111111
1111111111111111111111111111111111
1111111110000011111111000111111111
1111111110CCC011111100CC0111111111
1111111110000011111100000111111111
1111111111110000000000111111111111
111111111111000CC00011111111111111
111111111111000CC00011111111111111
111111111111000CC00011111111111111
1111111111110000000011111111111111
1111111E000000000000000000P1111111
1111111111111111111111111111111111
1111111111111111111111111111111111