1111111111111111111111111111111111111
10P0000000000000000000000000000000001
1111111111111111111111111110000000001
1C0000000000000000000000000000C000001
1000000000000000000000111111111111111
1000000000000000000000000000000000001
10000000000111111110000000000C0000001
1000000000011111111000000000000000001
1000000000011111111000000000000000001
1000000000000000111111111100000000001
100000000000000C111111111100000000001
10011100000000000000000C1100000000001
1001011111101111111111111100000000001
1000011000000000000E1C000000000000001
1111111111111111111111111111111111111