111111111111111111111111111111111111111111111111111
10P000000000000000000000000000000000000000000000001
111111111111111111111111111000000000000000000CCC001
1C0000000000000000000000000000C00000000000000CCC001
100000000000000000000011111111111111000000000CCC001
100000000000000000000000000000000000000000000CCC001
10000000000111111110000000000C000000C00000000CCC001
100000000001111111100000000000000000000000000000001
100000000001111111100000000000000000000000000000001
10000CCC0000000011111111110000000000000000000000001
100000000000000C11111111110000000000000000000000001
10011100000000000000000C110000000000000CCC000000001
100101111110111111111111110000000000000000000000001
1000011000000000000E1C00000000000000000000000000001
111111111111111111111111111111111111111111111111111