1111111111111111
10E0000000000001
101000000010C001
1000001110000001
100C001P10000001
1000001110100001
1000000000000001
1000000000100001
1000000000000001
1000000000C00001
1111111111111111