1111111111111111
10E1000000000001
111100000010C001
1000000000000001
100C000P00000001
1000000000100001
1000000000000001
1000000000100001
1000000000000001
1000000000C00001
1111111111111111