11111111111111111111111111111111111111111111111111111111111111111
11111111111111111111111111111111111111111111111111111111111111111
11111111111110000000000000000000000000000000000000000000000011111
11111111111110000000000000000000000000000000000000000000000011111
11111111111110000000000000000000000000000000000000000000000011111
11111111111110000000000000000000000000000000000000000000000011111
11111111111110000000000000000000000000000000000000000000000011111
11111111111110000000000000000000000000000000000000000000000011111
11111111111110000000000000000000000000000000000000000000000011111
11111111111110000000011111111111111111111111111111110000001111111
11111111111110000000011111111111111111111111111111110000001111111
11111111111110000000011111111111111111111111111111110000001111111
11111111111110000000011111111111111111111111111111110000001111111
11111111111110000000011111111111111111111111111111110000001111111
11111111111110000000011111111111111111111111111111110000001111111
11111111111110000000011111111111111111111111111111110000001111111
11111111111110000000011111111111111111111111111111110000001111111
111111P000000000000000000000000000000000000000000000000000000E111
11100000000000000000000000000000000000111111111111111111111111111
111000CCCCCCCCCCCCCCCCCCCCCCCCCCCC0000111111111111111111111111111
111000CCCCCCCCCCCCCCCCCCCCCCCCCCCC0000111111111111111111111111111
111000CCCCCCCCCCCCCCCCCCCCCCCCCCCC0000111111111111111111111111111
111000CCCCCCCCCCCCCCCCCCCCCCCCCCCC0000111111111111111111111111111
111000CCCCCCCCCCCCCCCCCCCCCCCCCCCC0000111111111111111111111111111
111000CCCCCCCCCCCCCCCCCCCCCCCCCCCC0000111111111111111111111111111
111000CCCCCCCCCCCCCCCCCCCCCCCCCCCC0000111111111111111111111111111
111000CCCCCCCCCCCCCCCCCCCCCCCCCCCC0000111111111111111111111111111
111000CCCCCCCCCCCCCCCCCCCCCCCCCCCC0000111111111111111111111111111
111000CCCCCCCCCCCCCCCCCCCCCCCCCCCC0000111111111111111111111111111
111000CCCCCCCCCCCCCCCCCCCCCCCCCCCC0000111111111111111111111111111
11100000000000000000000000000000000000111111111111111111111111111
11111111111111111111111111111111111111111111111111111111111111111
11111111111111111111111111111111111111111111111111111111111111111
11111111111111111111111111111111111111111111111111111111111111111