1111111111111111
10E0000000100001
101000000010C001
1000000000100001
100C000P00100001
1000000000100001
1000000000100001
1000000000100001
1000000000111111
1000000000C00001
1111111111111111